#############################
#***************************#
############****#############
#***************************#
#***************************#
#*****#**########***********#
#*****#**#******#***********#
#************#**************#
#############################